tuga: tuga tuzan tuzna tuzno tuznija tuznije tuzniji najtuzniji najtuznije najtuznija tuzni tuzne
sreca:  sreca srecan srecna srecno srecniji srecnija srecnije najsrecniji najsrecnija najsrecnije srecu srecnu srecne 
depresija: depresija depresivan depresivna depresivno depresivniji depresivnija depresivnije 
zelja: zelja zeljan zeljna zeljno zeljniji zeljnija zeljnije zelje zeljom zelju zeljena zeljeno zeljeni najzeljnija najzeljniji najzeljnije zeljom zeljama zeljnost 
radost: radostan radosna radosno radosnije radosnija radosniji najradosnija najradosnije najradosniji
iznenadjenje: iznenadjenje iznenadan iznenadna iznenadno iznenadjujuce
vera: veran verna verno vernija vernije verniji veru verovanje vernoj
ljubav: ljubav zaljubljen zaljubljena zaljubljeno ljubavno ljubavna ljubavni ljubavi
osecaj: osecaj osecajan osecajna osecajno
ljut: ljut ljuta ljuto ljuti ljutito ljutnja ljute ljutog ljutu ljutoj
bol: bol bolno bolna bolni bolnije bolnija bolniji najbolniji bolnog bolnoj
usamljeno: usamljeno usamljen usamljena usamljeni usamljenije usamljenija usamljeniji usamljenoj
euforija: euforija euforican euforicna euforicno euforije euforiju 
mizerija: mizerija mizerno mizeran mizerna mizerije mizerijom mizerijama mizeriju
ocaj: ocaj ocajno ocajna ocajni ocajniji ocajnije ocajniji najocajnija najocajnije
potreba: potreba potreban potrebna potrebno potrebniji potrebnije potrebnija najpotrebnije najpotrebnija najpotrebniji potrebu
nesreca: nesreca nesrecno nesrecna nesrecan nesrecniji nesrecnije nesrecnija
zadovoljno: zadovoljno zadovoljna zadovoljne zadovoljnija zadovoljnije zadovoljstvo
nezadovoljno: nezadovoljno nezadovoljna nezadovoljan nezadovoljnija nezadovoljnije nezadovoljstvo
nepotrebno: nepotrebno nepotreban nepotrebna nepotrebniji nepotrebnija nepotrebnije najnepotrebnije najnepotrebnija najnepotrebniji
porodica: porodica porodice porodicno porodicu porodicom porodicama porodici
strah: strah strasno strasna strasni strasnije strasniji strasnija najstrasnija najstrasnije najstrasniji strasnog strasne straha
odlicno: odlicno odlicna odlican odlicnog 
jad: jad jadan jadna jadni jadnici jadnice jadnica jadi jadnog jadnu jadnije 
beda: beda bednik bednica bednici bednije bednija bedniji
muka: muka mucenik mucenica mucenici mucenice mucenicu mucno mucan mucna mucnu mucnog mucne mucni mucniji mucnijih mucnije mucnija
nervoza: nervoza nervozno nervozni nervozna nervozniji nervoznija nervoznije nervoze nervozu
dobar: dobar dobro dobra dobri dobre bolji bolja bolje najbolje najbolji najbolja
kompjuter: kompjuter kompjutera kompjuteri kompjutere kompjuterom kompjuterima kompjuteru racunar racunari racunarom racunarima 
projekat: projekat projekata projekti projektu projektima projekta projektom
los: los losi lose losije losa losija olos najlosija najlosiji najlosije losu losoj
moj: moj moja moje moji mojim mojem mom mog moju mojoj mojeg
tvoj: tvoj tvoja tvoje tvoji tvojim tvojem tvom tvog tvoju tvojoj tvojeg
sestra: sestra sestre sestri sestrom sestrama sestara sestru sestrinoj
brat: brat braca bratu braci bratom bracom brata brace bracu bratovljevoj
otac: otac ocu ocem oca ocevi ocevima oceva oceve tata tate tati tatom tatama ocevog tatinog tatina tatin tatu tatinoj ocevoj 
majka: majka majke majkama majci majke majkom mama mame mamama mamom mami mamina maminog mamin mamu majku majkinoj maminoj majkinog 
muz: muz muzevi muzom muza
zena: zena zene zenom zenama
dete: dete deca decom detetom 
